********************
###############A####
##### ######### ####
###   ######### ####
#####           ####
#     ##############
# ##  ##############
####   #############
######      ########
##########       ###
#### ###### ########
#### ###### ########
#### ######  #######
#### ######  #######
####  #####  #######
######       #######
########  ##########
########  ##########
#######   ##########
######    ##########
########B###########